*******************************
*                             *
*  ***                    *** *
*  ***                    * ***
***                           *
* ***                       ***
*                             *
*******************************

