***************
*  ***        *
*  ***    *** *
*  ***    *** *
***           *
* ***         *
*             *
***************

