* ********* ***
* *** *** * ***
  * * * * *****
* **** **** ***
*** ** **** ***
* ****** ** ***
* * *** *** * *
* *** ** ** * *
